+-------------+
|   G   G     |
|            ++
|  T         |
|            |
|   X      C ++
|             |
+-------------+