+--------------------+
|                    |
|    C               |
|                    |
|                    |
|                    |
|   H      T         |
|                    |
|                    |
|             H      |
|                    |
|                    |
|    G               |
|                    |
+--------------------+

