+--------------------+
|                    |
|    C               |
|                    |
|                    |
|                    |
|          T         |
|                    |
|                    |
|                    |
|                    |
|                    |
|    G               |
|                    |
+--------------------+

