  
  +-------------+
  |M  G   G     |
  |             |
  |  T    M     |
  |             |
  |   X      C  |
  |             |
  +-------------+