+-------------+
|   G         |
|             |
|  T          |
|             |
|   X      C  |
|             |
+-------------+