+-----+----+
|1    |1   ++
|     |     |
|     |     |
|  C  |     |
|     |    2|
+-----+-----+
|    3|    3|
|     |     |
|     |     |
|     |     |
|T    |2    |
+-----+-----+
